####################
#...##.............#
#.#..#.####.####.###
#.#.##...#...#...#.#
#.#....#...#...#.#.#
###.########.###.#.#
#...#......#.......#
#.###.##.#.#.#######
#......#.#...#.....#
###.##.#.#.###.#####
#..............#...#
#.###.####.###.###.#
#.#........#.....#.#
#.#.######...###...#
#.#..#...#.#.....###
#.#.##.#.#.#####...#
#.#..#.#.#.#...###.#
#............#.....#
####################
