....................
.#.#.#.#.#.#.#.#.#..
.#.#.#.#.#.#.#.#.#..
.#.#.#.#.#.#.#.#.#..
.#.#.#.#.#.#.#.#.#..
.#.#.#.#.#.#.#.#.#..
.#.#.#.#.#.#.#.#.#..
.#.#.#.#.#.#.#.#.#..
..#.#.#.#.#.#.#.#.#.
.#.#.#.#.#.#.#.#.#..
.#.#.#.#.#.#.#.#.#..
.#.#.#.#.#.#.#.#.#..
.#.#.#.#.#.#.#.#.#..
.#.#.#.#.#.#.#.#.#..
.#.#.#.#.#.#.#.#.#..
.#.#.#.#.#.#.#.#.#..
.#.#.#.#.#.#.#.#.#..
.#.#.#.#.#.#.#.#.#..
....................
